X X X X X X X
X . . . . . X
X . . . . . X
X x x X x x X
X . . X . . X
X P . X . W X
X X X X X X X