7 8
X X X X X X X X
X W . . . . X X
X X X D X X . X
X . B B B I . X
X P X ! . . . X
X . X . . . . X
X X X X X X X X
The NOT gate will reverse the signal :
on becomes off and off becomes on.