X X X X X X X X X X
X . . . . . X . . X
X . ! . . . X . W X
X . . . . . X . . X
X . | . & . X D X X
X . . . . . X . . X
X . . P . . X X D X
X . . . . . . . . X
X . I . I B B B . X
X X X X X X X X X X