X X X X X X X X X X X
X . . . . . X X X X X
X . . . . . X X X X X
X X x X X B X X X X X
X . . . . B x . . . X
X . . . X B X . . . X
X . P . X . X . W . X
X . . . X . X . . . X
X X X X X X X X X X X