X X X X X X X X X
X . . . B . . . X
X . . . B . . . X
X . . . B . . . X
X x x x X x x x X
X . . . X . . . X
X . P . X . W . X
X . . . X . . . X
X X X X X X X X X