X X X X X X X X X
X . . . W . . . X
X . . . . . . . X
X . . . . . . . X
X X X X B X X X X
X . . . . . . . X
X . . . . . . . X
X . . . P . . . X
X X X X X X X X X