X X X X X X X X X
X . . X W . . . X
X . . . . . . . X
X x x X B X X X X
X . . . . . . . X
X . . . . . . . X
X . . . . . . . X
X . . . P . . . X
X X X X X X X X X