X X X X X X X
X . . W . . X
X . . . . . X
X x x x x x X
X . . . . . X
X . . P . . X
X X X X X X X