X X X X X X X X X
X . . . . . . . X
X . . . W . . . X
X . . . . . . . X
X X X X D0 X X X X
X . . . . . . . X
X . B . P . I0 . X
X . . . . . . . X
X X X X X X X X X