Outside the box
7 7
x x x x x x x
x . . . . . x
x . . P . . x
x . . . . . x
x B B B B B x
x . B W B . x
x x x x x x x