Or gate
9 9
X X X X X X X X X
X . . . X . . . X
X . I . D . W . X
X . . . X . . . X
X X D X X X X X X
X . . . . B . I X
X . P . | . . . X
X . . . . B . I X
X X X X X X X X X
An OR gate will turn on if AT LEAST one of its inputs is on.