Swap, swap and reswap!
9 21
X X X X X X X X X X X X X X X X X X X X X
X . . . D . . . X . . . D . . . X . . . X
X . . . X . . . X . . . X . . . X . W . X
X . . . X . . . D . . . X . . . D . . . X
X . . . X X X X X X X X X X X X X X X X X
X . . . . . . . . . . . . . . . . . . . X
X . P . . . . . . . . . . . . . . . I . X
X . . . . . . . . . . . . . . . . . . . X
X X X X X X X X X X X X X X X X X X X X X
Remember that you can Swap multiple times.