And gate
9 9
X X X X X X X X X
X . . . W . . . X
X . . . . . . . X
X X X X D X X X X
X . I . . . B . X
X . . . & . . . X
X . B . . . I . X
X . . . P . . . X
X X X X X X X X X
An AND gate will turn on if ALL of its inputs are on.
Use + to reset the level. Resetting is undoable.