The trap
7 7
X X X X X X X
X . X W . . X
X . . . . . X
X x x B X X X
X . . . . . X
X . . . P . X
X X X X X X X