Level Is Familiar
5 7
X X X X X X X
. . X . . . .
P . D . I . W
. . X . . . .
X X X X X X X